1111111111111
1101000000001
1100011110001
1P00110E000C1
1111111111111
