11111111111111
100C0000000001
10C11000000001
10001111110001
10001100000001
1000110E000001
10001000000001
10011100000C01
101C1100111101
11P0110011C111
10C00000000111
11111111111111
